{
  "name": "The Silent Heist",
  "story": "Infiltrate the corporate headquarters to steal the prototype data. Avoid detection at all costs.",
  "rules": ["don't be spotted", "don't kill anyone"],
  "objectives": ["steal"],
  "tilesize": 32,
  "cols": 15,
  "rows": 15,
  "player": {"x": 1, "y": 1},
  "grid": [
    20,20,20,20,20,20,20,20,20,20,20,20,20,20,20,
    20,100,0,0,0,0,0,0,0,0,0,0,0,0,20,
    20,0,0,0,0,0,0,0,0,0,0,0,0,0,20,
    20,0,0,20,20,0,0,0,0,0,20,20,0,0,20,
    20,0,0,20,20,0,0,0,0,0,20,20,0,0,20,
    20,0,0,0,0,0,0,0,0,0,0,0,0,0,20,
    20,0,0,0,0,0,0,201,0,0,0,0,0,0,20,
    20,0,0,0,0,0,0,0,0,0,0,0,0,0,20,
    20,0,0,0,0,0,0,0,0,0,0,0,0,0,20,
    20,0,0,20,20,0,0,0,0,0,20,20,0,0,20,
    20,0,0,20,20,0,0,0,0,0,20,20,0,0,20,
    20,0,0,0,0,0,0,0,0,0,0,0,0,0,20,
    20,0,0,0,0,0,0,0,0,0,0,0,0,0,20,
    20,0,0,0,0,0,0,0,0,0,0,0,0,99,20,
    20,20,20,20,20,20,20,20,20,20,20,20,20,20,20
  ],
  "enemies": [
    {"x": 7, "y": 6, "type": "guard", "patrol": [[7,6], [8,6], [8,7], [7,7]]}
  ],
  "objects": [
    {"x": 13, "y": 13, "type": "documents", "name": "Prototype Data"}
  ]
}